...........................############################################...........................
...........................############################################...........................
...........................   ####   ####        ##                    ...........................
...........................   ####  ####         ##                    ...........................
...........................   #### ####          ##                    ...........................
...........................   #######            ##                    ...........................
...........................   #####              ##                    ...........................
...........................   ####               #####                 ...........................
...........................   ####              #######                ...........................
...........................   ####              #######                ...........................
...........................   ####             #######                 ...........................
...........................   ####           ######                    ...........................
...........................   ####          #######                    ...........................
...........................   ####          #######                    ...........................
...........................   ####          #######                    ...........................
...........................   ####          #######                    ...........................
...........................   ####           ######                    ...........................
...........................   ####            ######                   ...........................
...........................   ####             #####                   ...........................
...........................   ####             #####                   ...........................
...........................   ####             #####                   ...........................
...........................   ####             #####                   ...........................
...........................   ####            #####                    ...........................
...........................   ####         #########                   ...........................
...........................   ####         #########                   ...........................
...........................   ####         ##     ##                   ...........................
...........................   ####        ###     ###                  ...........................
...........................   ####        ###     ###                  ...........................
........................... ############# ###########                  ...........................
........................... ############# ##      ###                  ...........................
........................... ############# ##      ###                  ...........................
