............................############################################............................
............................############################################............................
............................   ####   ####        ##                    ............................
............................   ####  ####         ##                    ............................
............................   #### ####          ##                    ............................
............................   #######            ##                    ............................
............................   #####              ##                    ............................
............................   ####              #  #                   ............................
............................   ####             #    #                  ............................
............................   ####             #    #                  ............................
............................   ####              #  #                   ............................
............................   ####               ##                    ............................
............................   ####                                     ............................
............................   ####                                     ............................
............................   ####                                     ............................
............................   ####                                     ............................
............................   ####                                     ............................
............................   ####                                     ............................
............................   ####                                     ............................
............................   ####                                     ............................
............................   ####                                     ............................
............................   ####                                     ............................
............................   ####                                     ............................
............................   ####                                     ............................
............................   ####                                     ............................
............................   ####                                     ............................
............................   ####                                     ............................
............................   ####                                     ............................
............................ #############                              ............................
............................ #############                              ............................
............................ #############                              ............................