...........................############################################...........................
...........................############################################...........................
...........................   ####    ####       ##                    ...........................
...........................   ####  ####         ##                    ...........................
...........................   #### ####          ##                    ...........................
...........................   #######            ##                    ...........................
...........................   #####              ##                    ...........................
...........................   ####               ##                    ...........................
...........................   ####               ##                    ...........................
...........................   ####               ## #####              ...........................
...........................   ####              ##########             ...........................
...........................   ####            ############             ...........................
...........................   ####           ###########               ...........................
...........................   ####          #######                    ...........................
...........................   ####          #######                    ...........................
...........................   ####          #######                    ...........................
...........................   ####           ######                    ...........................
...........................   ####            ######                   ...........................
...........................   ####             #####                   ...........................
...........................   ####             #####                   ...........................
...........................   ####             #####                   ...........................
...........................   ####             ####                    ...........................
...........................   ####             ###                     ...........................
...........................   ####             ####                    ...........................
...........................   ####                                     ...........................
...........................   ####                                     ...........................
...........................   ####                  ################   ...........................
...........................   ####                       ###      ###  ...........................
........................... #############                ###      ###  ...........................
........................... #############          #################   ...........................
........................... #############                              ...........................
