............................                                            ............................
............................   ####    ####                             ............................
............................   ####   ####                              ............................
............................   ####  ####                               ............................
............................   #### ####                                ............................
............................   #######                                  ............................
............................   #####                                    ............................
............................   ####                                     ............................
............................   ####                                     ............................
............................   ####                                     ............................
............................   ####                                     ............................
............................   ####                                     ............................
............................   ####                                     ............................
............................   ####                                     ............................
............................   ####                                     ............................
............................   ####                                     ............................
............................   ####                                     ............................
............................   ####                                     ............................
............................   ####                                     ............................
............................   ####                                     ............................
............................   ####                                     ............................
............................   ####                                     ............................
............................   ####                                     ............................
............................   ####                                     ............................
............................   ####                                     ............................
............................   ####                                     ............................
............................   ####                                     ............................
............................   ####                                     ............................
............................ #############                              ............................
............................ #############                              ............................
............................ #############                              ............................