...........................############################################...........................
...........................############################################...........................
...........................   ####   ####        ##                    ...........................
...........................   ####  ####         ##                    ...........................
...........................   #### ####          ##                    ...........................
...........................   #######            ##                    ...........................
...........................   #####              ##                    ...........................
...........................   ####              #  #                   ...........................
...........................   ####             #    #                  ...........................
...........................   ####             #    #                  ...........................
...........................   ####              #  #                   ...........................
...........................   ####               ##                    ...........................
...........................   ####                                     ...........................
...........................   ####                                     ...........................
...........................   ####                                     ...........................
...........................   ####                                     ...........................
...........................   ####                                     ...........................
...........................   ####                                     ...........................
...........................   ####                                     ...........................
...........................   ####                                     ...........................
...........................   ####                                     ...........................
...........................   ####                                     ...........................
...........................   ####                                     ...........................
...........................   ####         #########                   ...........................
...........................   ####         #########                   ...........................
...........................   ####         ##     ##                   ...........................
...........................   ####        ###     ###                  ...........................
...........................   ####        ###     ###                  ...........................
........................... ############# ###########                  ...........................
........................... ############# ##      ###                  ...........................
........................... ############# ##      ###                  ...........................
