............................############################################............................
............................############################################............................
............................   ####   ####        ##                    ............................
............................   ####  ####         ##                    ............................
............................   #### ####          ##                    ............................
............................   #######            ##                    ............................
............................   #####              ##                    ............................
............................   ####              #  #                   ............................
............................   ####             #    #                  ............................
............................   ####             #    #                  ............................
............................   ####              #  #                   ............................
............................   ####               ##                    ............................
............................   ####                                     ............................
............................   ####                                     ............................
............................   ####                                     ............................
............................   ####                                     ............................
............................   ####                                     ............................
............................   ####                                     ............................
............................   ####                                     ............................
............................   ####                                     ............................
............................   ####                                     ............................
............................   ####                                     ............................
............................   ####                                     ............................
............................   ####         #########                   ............................
............................   ####         #########                   ............................
............................   ####         ##     ##                   ............................
............................   ####        ###     ###                  ............................
............................   ####        ###     ###                  ............................
............................ ############# ###########                  ............................
............................ ############# ##      ###                  ............................
............................ ############# ##      ###                  ............................