............................############################################............................
............................############################################............................
............................   ####   ####        ##                    ............................
............................   ####  ####         ##                    ............................
............................   #### ####          ##                    ............................
............................   #######            ##                    ............................
............................   #####              ##                    ............................
............................   ####               #####                 ............................
............................   ####              #######                ............................
............................   ####              #######                ............................
............................   ####             #######                 ............................
............................   ####           ######                    ............................
............................   ####          #######                    ............................
............................   ####          #######                    ............................
............................   ####          #######                    ............................
............................   ####          #######                    ............................
............................   ####           ######                    ............................
............................   ####            ######                   ............................
............................   ####             #####                   ............................
............................   ####             #####                   ............................
............................   ####             #####                   ............................
............................   ####             #####                   ............................
............................   ####            #####                    ............................
............................   ####         #########                   ............................
............................   ####         #########                   ............................
............................   ####         ##     ##                   ............................
............................   ####        ###     ###                  ............................
............................   ####        ###     ###                  ............................
............................ ############# ###########                  ............................
............................ ############# ##      ###                  ............................
............................ ############# ##      ###                  ............................