............................############################################............................
............................############################################............................
............................   ####    ####       ##                    ............................
............................   ####  ####         ##                    ............................
............................   #### ####          ##                    ............................
............................   #######            ##                    ............................
............................   #####              ##                    ............................
............................   ####               ##                    ............................
............................   ####               ##                    ............................
............................   ####               ## #####              ............................
............................   ####              ##########             ............................
............................   ####            ############             ............................
............................   ####           ###########               ............................
............................   ####          #######                    ............................
............................   ####          #######                    ............................
............................   ####          #######                    ............................
............................   ####           ######                    ............................
............................   ####            ######                   ............................
............................   ####             #####                   ............................
............................   ####             #####                   ............................
............................   ####             #####                   ............................
............................   ####             ####                    ............................
............................   ####             ###                     ............................
............................   ####             ####                    ............................
............................   ####                                     ............................
............................   ####                                     ............................
............................   ####                  ################   ............................
............................   ####                       ###      ###  ............................
............................ #############                ###      ###  ............................
............................ #############          #################   ............................
............................ #############                              ............................